R 11111 1111111
NO texture/WALL93.xpm
SO texture/WALL20.xpm
WE maps/test.xpm
EA texture/WALL54.xpm
S maps/test11.xpm
F 220,100,0
C 225,30,0

11111111111111111111111111111111
10000000000000000000000000000001
10222222222222222222222222222201
10222222222222222222222222222201
10222222222220022222222222222201
10222222222220022222222222222201
10222222222220022222222222222201
10222222222220022222222222222201
10222222222220022222222222222201
10000000000000000000000000000001
11111111111100000111111111111111
11111111111100000111111111111111
11111111111100000111111111111111
11111111111100000111111111111111
11111111111100N00111111111111111
11111111111111111111111111111111
