R 1000 1000
NO texture/WALL93.xpm
SO texture/WALL20.xpm
WE maps/test.xpm
EA texture/WALL54.xpm
S  maps/test11.xpm
F 22,100,0
C 225,30,0

1111111111111111111111111111111111111111111111111111111111111111111111111111111111111111111
1000000000000000002000000000000000000000000000000000000000000000000000000000002000000000001
10000000000000000000002000000000000000000000000020000000000000002000000000000002000000000001
10000000000020000000000000000000000000000200000000000000000000000000200000000000000000000111
1000000000000002000000000000000000000000000000000000000000200000000000000000000020000000001
1000000000000000000111111000000000000000000000000000000000000000000000000000200002000000001
10000000000000011110000000000000000000000000000000000000000000000000000000000000000000011111
10000000000111100000002000000000000000000000000000000000000200000000000000000200200000000001
10000000000100000000000000000000000000002000000000000000000000000000000000000000000000001111
100000000000100000000000000000000000000000000000000000000000000000000000020000020000000001
100000000000010000000000000020000000000000000000000000000000000000000000000000000000000011
1000000000000010000020000000000000000000000000020000000000000000000000000000002000000000001
100000000000000100000000000000000000000000W00000000000000000000000000200000000000000000011
1000000000000000100200000000002000000000000000000000000000000000000000000000000020000000001
1000000000000000010000000000000000000000002000000000000000000000000000000000000000000000111
10000000000000000010000200000020000000000000020000000000000000000000000000200000000000000001
100000000000000020000000000200000000000200000000020000000000000200000000000000000000000000001
100000000000000000000000020002000000000000000000000000000000000000000000000000000000000001111
100000000000000000020000000000000002000000000000000020000000000000000002000000200000000000001
100000000000000000000000000000000000000000200000000000000000000000000000200000000000000001111
1000000000000000000000000000000000000000000000000000200000000200000020000000000000000000001
100000000000000000000000000000000000000000000000000000000000000000000000000000000000000111
1000000000000000000000000000000000000000000000000000000000000000000000000000000000000001
1000000000000000000000000000000000000000000000000000000000000000000000000000000000000001
1000000000000000000000000000000000000000000000000000000000000000000000000000000000000001
1111111111111111111111111111111111111111111111111111111111111111111111111111111111111111
